10,5
x0x0x0x0x0x0x0x0x0x0
x0psx0 0 0 0x0 0 0x0
x0 0x0 0x0 0x0x0 0x0
x0 0 0 0x0 0 0 0 0x0
x0x0x0x0x0x0x0x0x0x0