15,12
x3x1x1x1x1x1x1x1x1x1x1x1x1x1x2
x0 0 0 0 ee0 0 0 0 0 0 0 0 0x0
x0 0x0 0 0x0 0x0 0x0 0 0 0 0x0
x0 0x0 0 0x0 0x0 0x0 0 0 0 0x0
x0 0x0 0 0x0 0x0 0x0 0 0 0 0x0
x0 0 0 0 0 0 0 0 0x0en 0 0 0x0
x0 0x0 0 0x0 0x0 0x0 0 0 0 0x0
x0 0x0 0 0x0 0x0 0x0 0 0 0 0x0
x0pnx0 0 0 0 0 0ew 0 0 0 0 0x0
x0 0 0 0es 0 0 0 0x0 0 0 0 0x0
x0 0 0 0 0 0 0 0 0x0 0 0 0 0x0
x3x1x1x1x1x1x1x1x1x1x1x1x1x1x2