15,15
x0x0x0x0x0x0x0x0x0x0x0x0x0x0x0
x0 0 0 0 0 0 0 0 0 0 0 0 0 0x0
x0 0x0 0 0x0 0x0 0x0 0 0 0 0x0
x0 0x0 0 0x0 0x0 0x0 0 0 0 0x0
x0 0x0 0 0x0 0x0 0x0 0 0 0 0x0
x0 0 0 0 0 0 0 0 0x0 0 0 0 0x0
x0 0x0 0 0x0 0x0 0x0 0 0 0 0x0
x0 0x0 0 0x0 0x0 0x0 0 0 0 0x0
x0pnx0 0 0 0 0 0ew 0 0 0 0 0x0
x0 0 0 0 0 0 0 0 0x0 0 0 0 0x0
x0 0 0 0 0 0 0 0 0x0 0 0 0 0x0
x0 0 0 0 0 0 0 0 0x0 0 0 0 0x0
x0 0 0 0 0 0 0 0 0x0 0 0 0 0x0
x0 0 0 0 0 0 0 0 0 0 0 0 0 0x0
x0x0x0x0x0x0x0x0x0x0x0x0x0x0x0